110010000
000010010
010011100
000010100
111010111
001010010
100010000
000010110
110010010